timestamp,avg,qty
1576816500,1601,1
1577122800,1305,1
1578346500,5716,1
1581465300,2218,1
1582309500,15,1
1582311300,15,1
1582313400,15,1
1582417500,10,2
1583304300,10,1
1583704800,3203,1
1585773600,3797,1
1587989700,5880,1
1593481500,10,1
1594233300,10,1
1603556100,1000,1